NO ./pizza.xpm
SO ./purplestone.xpm
WE ./puro_c.xpm
EA ./gang.xpm

F 220,100,0
C 225,30,0

111111111111111111111111
1000000000000000000000001
1011000000000000000000001
100100000000000000000000111111111
111111111000000000000000000000001
100000000011000000000000000111111
11110000000000000000000000000001
 1111000000000000000010000001111
  110000000000000000000000000001111
    10000000000000001100000010001
    1000000000000000000000000001111
     11000000000000000000000000111111
     11111000000000000000000000111111
      111100000000000000000000N000001     1111111    111   
111111111111110011111100111111111111111
1111111111111111111111000111111111111111110
111111111111111111111111111111111111111111111
