SO ./doom2.xpm
NO                      ./doom.xpm      
WE ./doom3.xpm
EA ./doom4.xpm

F 220,100,0
C 225,30,0

1111111111111111111111111
1000000000110000000000001
10110000N1110000000000001
10010000000000000000011111111111
111111111011000001110000000000001
1000000000110000011100000000111111
11110111111111011100000010001
11110000000000011101010010001111
11000000100101011100000010001111
10000000000000001100000010001
10000001110000011101010010001
11000001 1010101 111011110111
1000000111000001110000000000111
1111111111011111111111111111110