NO ./tex1.xpm
SO ./tex2.xpm
WE ./tex3.xpm
EA ./tex4.xpm

F 220,100,0
C 225,30,0

111111111111111111111111
1000000000110000000000001
1011000001110000000000000
100100000000000000000000111111111
111111111011000001110000000000001
100000000011000001110111111111111
11110111111111011100000010001
 11110111111111011101010010001111
  11000000110101011100000010001111
    10000000000000001100000010001
    10000000000000001101010011111
     11000001 1010101 11101111111111
     11110111 1110101 101111011100001
      111111111111111111111111N000001     1111111    111   
111111111111110011111100111111111111111
1111111111111111111111000111111111111111110
111111111111111111111110111111111111111111111
